25 26
13 19
Background
0  0  0  0  0  0  0  0  0  0  26 26 26 26 26 26 26 26 26 26 26 26 26 26 26
0  0  0  0  0  0  0  0  0  0  26 26 26 26 26 26 26 26 26 26 43 43 45 0  0
0  0  0  0  0  0  0  0  0  0  26 26 26 26 26 26 43 43 43 43 43 0  0  0  0
0  0  0  0  0  0  0  0  0  0  26 26 26 26 26 26 43 0  0  0  0  0  0  0  0
0  0  0  0  0  0  0  0  0  0  26 26 26 26 26 26 44 0  0  0  0  0  0  0  0
0  0  0  0  0  0  0  0  0  0  26 26 26 26 26 26 0  0  0  0  0  0  0  0  0
0  0  0  0  0  0  0  0  0  0  26 26 26 26 26 26 0  0  0  0  0  0  0  0  0
0  0  0  0  0  0  0  0  0  0  0  0  0  0  0  0  0  0  0  0  0  0  0  0  0
0  0  0  0  0  0  0  0  0  0  0  0  0  0  0  0  0  0  0  0  0  0  0  0  0
0  0  0  0  0  0  0  0  0  0  0  0  0  0  0  0  0  0  0  0  0  0  0  0  0
0  0  0  0  0  0  0  0  0  0  0  0  0  0  0  0  0  0  0  0  0  0  0  0  0
0  0  0  0  0  0  0  0  0  0  0  0  0  0  0  0  0  0  0  0  0  0  0  0  0
0  0  0  0  0  0  0  0  0  0  0  0  0  0  0  0  0  0  0  0  0  0  0  0  0
0  0  0  0  0  0  0  0  0  0  0  0  0  0  0  0  0  0  0  0  0  0  0  0  0
0  0  0  0  0  0  0  0  0  0  0  0  0  0  0  0  0  0  0  0  0  0  0  0  0
0  0  0  0  0  0  0  0  0  0  0  0  0  0  0  0  0  0  0  0  0  0  0  0  0
0  0  0  0  0  0  0  0  0  0  0  0  0  0  0  0  0  0  0  0  0  0  0  0  0
0  0  0  0  0  0  0  0  0  0  0  0  0  0  0  0  0  0  0  0  0  0  0  0  0
0  0  0  0  0  0  0  0  0  0  0  0  0  0  0  0  0  0  0  0  0  0  0  0  0
0  0  0  0  0  0  0  0  0  0  0  0  0  0  0  0  0  0  0  0  0  0  0  0  0
0  0  0  0  0  0  0  0  0  0  0  0  0  0  0  0  0  0  0  0  0  0  0  0  0
0  0  0  0  0  0  0  0  0  0  0  0  0  0  0  0  0  0  0  0  0  0  0  0  0
0  0  0  0  0  0  0  0  0  0  0  0  0  0  0  0  0  0  0  0  0  0  0  0  0
0  0  0  0  0  0  0  0  0  0  0  0  0  0  0  0  0  0  0  0  0  0  0  0  0
0  0  0  0  0  0  0  0  0  0  0  0  0  0  0  0  0  0  0  0  0  0  0  0  0
0  0  0  0  0  0  0  0  0  0  0  0  0  0  0  0  0  0  0  0  0  0  0  0  0
Main
26 26 26 26 26 26 20 29 29 21 25 25 28 30 27 26 26 26 20 29 29 29 29 29 29
26 26 26 26 20 29 30 2  2  25 25 25 26 26 27 20 29 29 30 20 29 29 29 29 29
26 26 26 26 27 2  2  2  2  25 25 25 26 26 27 27 20 29 29 30 43 43 45 1  1
26 26 20 29 30 2  2  2  2  25 25 25 26 26 27 27 27 43 43 43 43 43 45 1  1
26 26 27 2  2  2  2  2  2  25 25 25 26 26 27 27 27 44 44 44 44 44 46 1  1
26 26 27 2  2  2  2  2  2  25 25 28 31 32 30 27 27 0  0  0  0  0  0  1  1
26 26 27 2  2  2  2  2  2  25 28 29 31 32 29 30 27 0  0  0  0  0  0  1  1
26 26 27 0  0  0  0  0  0  28 29 29 31 32 29 29 30 0  0  0  0  0  0  1  1
26 26 27 0  0  0  0  0  0  0  0  0  0  0  0  0  0  0  0  0  0  0  0  1  1
26 26 27 0  0  0  0  0  0  0  0  8  9  10 0  0  0  0  0  0  0  1  1  1  1
20 29 30 0  0  0  0  0  0  8  9  16 7  17 9  10 0  0  0  0  0  1  1  1  1
27 0  0  0  0  0  0  8  9  16 7  7  7  19 14 15 0  0  0  0  0  1  1  1  1
27 0  0  0  0  0  33 33 35 35 39 40 7  12 0  0  0  0  0  0  0  1  1  1  1
27 0  0  0  0  0  34 34 36 36 41 42 7  12 0  0  0  0  0  0  0  1  1  1  1
27 0  0  0  0  0  0  11 7  7  37 38 19 15 0  0  0  0  0  0  0  1  1  1  1
27 2  2  2  2  8  9  16 7  7  37 38 12 0  0  0  0  0  0  0  0  1  1  1  1
27 2  2  2  2  11 7  7  7  7  37 38 15 0  0  0  0  0  0  0  0  1  1  1  1
27 2  2  2  2  11 7  7  19 14 31 32 0  0  0  0  0  0  0  0  0  1  1  1  1
30 2  2  8  9  16 7  7  12 0  31 32 0  0  0  0  0  0  0  0  0  0  0  1  1
9  9  9  16 7  7  7  7  12 0  0  0  0  0  0  0  0  0  0  0  0  0  0  1  1
7  7  7  7  7  7  19 14 15 0  0  0  0  0  0  0  0  0  0  0  0  0  0  1  1
7  7  7  19 14 14 15 0  0  0  0  0  0  0  0  0  0  0  0  0  0  0  0  8  9
7  7  7  12 0  0  0  0  0  0  0  0  0  0  0  0  0  0  0  0  0  8  9  16 7
7  7  7  12 0  0  0  0  0  0  0  0  0  0  0  0  0  0  0  0  0  11 7  7  7
7  7  7  12 0  0  0  0  0  0  0  0  0  0  0  0  0  0  0  0  8  16 7  7  7
7  7  7  12 22 23 23 23 23 23 23 23 23 23 23 23 23 24 8  9  16 7  7  7  7
